F 200,30,250
SO ./path_to_the_so_texture
EA path_to_the_east_texture
C 150,200,99
WE               ./path_to_the_west_texture


NO ./path_to_the_north_texture




111111111111111111111111111111111111111111111111111111111111
1S000000000000000000011111111111 111111111111
1111111111111111111111111111111111111111         1
                                 11
